11111111111111111111111
10000000110001100000001
10000000000010000000001
10000000000P00000000001
10000000000000000000001
11111111111111111111111
