1111111111111111
1000000000001001
1P00000000001001
            1000000000001001
1111111000000001
1000000000000001
1000000000000001
1001111000000001
1001000000000001
1111111111111111