NO xpm_files/TECH_1A_1.xpm
C 250,30,0
SO xpm_files/TECH_2A_1.xpm
F 255 ,100,4
EA xpm_files/TECH_4A_1.xpm
WE xpm_files/TECH_3A_1.xpm

        1111111111111111111111111
        100000000011000000000000011111111111111111
        10110000011110000000000001
        1001000000010000000000001
111111111011000001110000000000001
10000000001100P001110111111111111
11110111111111011100000010001
11110111111111011101010010001
11000000110101011100000010001
100000000000001100000010001
100000000P000001101010010001
1100000111010101 11101111000111
11110111 1110101 101111010001   
11111111 1111111 111111111111
11111111111111111111111111111