1111111111
1000100011
1010001001
10000P0001
1000000001
1111111111
