111111111111111111111
100000100000000000001
100000100000000101101
1000001000P0000101001
111000010000111101001
100000000000000000001
111111111111111111111
