NO xpm_files/TECH_1A_1.xpm
C 250,30,0
SO xpm_files/TECH_2A_1.xpm
WE xpm_files/TECH_3A_1.xpm
F 255,100,0
EA xpm_files/TECH_4A_1.xpm







      11111111111111111111
11111111111           
100000100000000000001
100000100000000101101
1000001000P0000101001
         
111000010000111101001
100000000000000000001
111111111111111111111