11111111111111111111111
10000000110001100000001
10001000011011000000001
10000000000000000000001
10001000001000000100001
10000000000000000000001
10001001000000000100001
10000000000000000000001
10000010000010000000001
10000000100000001000001
10000000000P00100001001
10001000000000000000001
10001000010000001001001
10000000000010010000001
10000000000000000000001
10000000000000000000001
10000000000000000000001
11111111111111111111111
