111111111111111111111
1P0000000000000000001
11111111100000000000111111
    1000000000000000000001
11111000000000000000011111
1000101000001111000001
1000101000000000000001
1000101000000000111101
10000000000P0000000001
1000000000000000000001
1000000000000000111111
1111111111111100000111
1111111111111111111111